>JX009738.1 Colletotrichum alatae culture ICMP:17919 calmodulin (CAL) gene, partial cds
CCTCTTTGTAAGTCCTGTTTCTTCACCTCGCTGCCATTTCTTGCTTCCGGCAACAGTCGTGGCCTTTGCT
AACCCACCCAAGGACAAGGATGGCGATGGTCAGTGCCTCACCCCGTTTGCTCCCCTCCGATGCGCTTCTG
AGAACGCCGTTCGCGACCGTCGATACACCAGTGGCATTCGATACCGCCGTCGAGACATATAGAATCGGGC
TAAACAGTTGGACAGGCCAAATCACTACAAAGGAGCTGGGCACCGTCATGCGCTCTCTCGGCCAGAACCC
CTCCGAGTCGGAGCTCCAGGACATGATCAACGAGGTCGACGCCGACAACAACGGCACCATCGACTTTCCC
GGTAGGTGGACATGCGGCATCTTGCGTCACACAACTCAGGCCCCCGCTGACTGATCTCCAGAGTTCCTGA
CGATGATGGCCCGGAAGATGAAGGATACCGACTCCGAAGAGGAGATTCGCGAGGCTTTCAAGGTTGGCTA
TGACAACGCTTTCCCGCTGCGACCCATGTTGACTCTGAATAGGTCTTTGACCGCGACAATAACGGCTTCA
TCTCCGCCGCCGAGCTTCGTCACGTCATGACCTCCATTGGTGAAAAGCTTACCGACGATGAGGTTGACGA
GATGATTCGCGAAGCCGATCAGGACGGCGATGGACGCATTGACTGTGAGTGACGATTACGATTGGTGTGC
GTCATGGGCACTAACAGGCGGTGTAGACAACGAGTT


>JX009739.1 Colletotrichum alatae culture CBS:304.67 calmodulin (CAL) gene, partial cds
CCTCTTTGTAAGTCCTGTTTCTTCACCTCGCTGCCATTTCTTGCTTCCGGCAACAGTCGTGGCCTTTGCT
AACCCACCCAAGGACAAGGATGGCGATGGTCAGTGCCTCACCCCGTTTGCTCCCCTCCGATGCGCTTCTG
AGAACGCCGTTCGCGACCGTCGATACACCAGTGGCATTCGATACCGCCGTCGAGACATATAGAATCGGGC
TAAACAGTTGGACAGGCCAAATCACTACAAAGGAGCTGGGCACCGTCATGCGCTCTCTCGGCCAGAACCC
CTCCGAGTCGGAGCTCCAGGACATGATCAACGAGGTCGACGCCGACAACAACGGCACCATCGACTTTCCC
GGTAGGTGGACATGCAGCATCTTGCGTCACACAACTCAGGCCCCCGCTGACTGATCTCCAGAGTTCCTGA
CGATGATGGCCCGGAAGATGAAGGATACCGACTCCGAAGAGGAGATTCGCGAGGCTTTCAAGGTTGGCTA
TGACAACGCTTTCCCGCTGCGACCCATGTTGACTCTGAATAGGTCTTTGACCGCGACAATAACGGCTTCA
TCTCCGCCGCCGAGCTTCGTCACGTCATGACCTCCATTGGTGAAAAGCTTACCGACGATGAGGTTGACGA
GATGATTCGCGAAGCCGATCAGGACGGCGATGGACGCATTGACTGTGAGTGACGATTACGATTGGTGTGC
GTCATGGGCACTAACAGGCGGTGTAGACAACGAGTT

>JX009670.1 Colletotrichum fructicola culture ICMP:18120 calmodulin (CAL) gene, partial cds
CCTCTTTGTGAGTCCCTTTCTTCATCTCGCTGCCATCTCTTGCTCCTGGCGACAGTCGTGGCCTTTGCTA
ACCCACACAAGGACAAGGATGGCGATGGTCAGTGCCTCACCCCTTTTGCTCCCCTTCGATGCGCTCCTGG
GAACGCCGTTCGCGACCGTCGATACACCAGCGGCATTCGATGCCGCCGTCGAGGCATGTAGAATCGAGCT
AAAGAGTTGGACAGGCCAAATCACTACAAAGGAGCTGGGCACCGTCATGCGCTCTCTCGGCCAGAACCCC
TCCGAGTCGGAGCTCCAGGACATGATCAACGAGGTCGACGCCGACAACAACGGCACCATCGACTTTCCCG
GTAGGTGGACACGCGGAATCCTGCGTCACACAATACAGACCCGCTGACTGTCCTCCAGAGTTCCTGACTA
TGATGGCCCGCAAGATGAAGGATACAGACTCCGAAGAGGAGATTCGCGAGGCTTTCAAGGTTGGCTACGA
CGGTGCTTTTCCGCTGCGATTGATGTTGACTCTGAGTAGGTCTTTGACCGCGACAACAACGGCTTCATCT
CCGCCGCCGAGTTGCGTCACGTCATGACCTCCATTGGTGAGAAGCTTACCGACGACGAGGTTGACGAGAT
GATTCGCGAGGCCGATCAGGACGGCGATGGACGCATTGACTGTGAGTGTCGATTGATTGGTATGCGTCAT
GGGCACTAACAGGCGGTGTAGACAACGAGTT

>JX009669.1 Colletotrichum fructicola culture ICMP:18125 calmodulin (CAL) gene, partial cds
CCTCTTTGTGAGTCCCTTTCTTCATCTCGCTGCCATCTCTTGCTCCTGGCGACAGTCGTGGCCTTTGCTA
ACCCACACAAGGACAAGGATGGCGATGGTCAGTGCCTCACCCCTTTTGCTCCCCTTCGATGCGCTCCTGG
GAACGCCGTTCGCGACCGTCGATACACCAGCGGCATTCGATGCCGCCGTCGAGGCATGTAGAATCGAGCT
AAAGAGTTGGACAGGCCAAATCACTACAAAGGAGCTGGGCACCGTCATGCGCTCTCTCGGCCAGAACCCC
TCCGAGTCGGAGCTCCAGGACATGATCAACGAGGTCGACGCCGACAACAACGGCACCATCGACTTTCCCG
GTAGGTGGACACGCGGAATCCTGCGTCACACAATACAGACCCGCTGACTGTCCTCCAGAGTTCCTGACTA
TGATGGCCCGCAAGATGAAGGATACAGACTCCGAAGAGGAGATTCGCGAGGCTTTCAAGGTTGGCTACGA
CGGTGCTTTTCCGCTGCGATTGATGTTGACTCTGAGTAGGTCTTTGACCGCGACAACAACGGCTTCATCT
CCGCCGCCGAGTTGCGTCACGTCATGACCTCCATTGGTGAGAAGCTTACCGACGACGAGGTTGACGAGAT
GATTCGCGAGGCCGATCAGGACGGCGATGGACGCATTGACTGTGAGTGTCGATTGATTGGTATGCGTCAT
GGGCACTAACAGGCGGTGTAGACAACGAGTT

>JX009715.1 Colletotrichum siamense culture ICMP:18121 calmodulin (CAL) gene, partial cds
CCTCTTTGTAAGTCCCTTTCTTCATCTCGCTGCCATCTCTTGCTCCTGGCGACAGTCGTGGCCTTTGCTA
ACCCACACAAGGACAAGGATGGCGATGGTCAGTGCCTCACCCCTTTTGCTCCCCTTCGATGCGCTCCTGG
GAACGCCGTTCGCGACCGTCGATACACCAGCGGCATTCGATGCCACCGTCGAGGCATGTAGAATCGAGCT
AAAGAGTTGGACAGGCCAAATCACTACAAAGGAGCTGGGCACCGTCATGCGCTCTCTCGGCCAGAACCCC
TCCGAGTCGGAGCTCCAAGACATGATCAACGAGGTCGACGCCGACAACAACGGCACCATCGACTTTCCCG
GTAGGTGGACATGCGGAATCCTGCGTCACACCATACAGGCCCGCTGACTGGTCTTCAGAGTTCCTGACTA
TGATGGCCCGCAAGATGAAGGATACCGACTCCGAAGAGGAGATTCGCGAGGCTTTCAAGGTTGGCTACGA
TGGTGCTTTTTCGCTGCGATATATGTTGACTCTGAATAGGTCTTTGACCGCGACAACAACGGCTTCATCT
CCGCCGCCGAGTTGCGTCACGTCATGACCTCCATTGGTGAGAAGCTTACCGACGACGAGGTTGACGAGAT
GATTCGCGAGGCCGATCAGGATGGCGATGGACGCATTGACTGTGAGTGTCGATTGATTGGTATGCGTCAT
GGGCACTAACAGGCGGTGTAGACAACGAGTT

>JX009700.1 Colletotrichum siamense culture ICMP:18117 calmodulin (CAL) gene, partial cds
CCTCTTTGTAAGTCCCTTTCTTCATCTCGCTGCCATCTCTTGCTCCTGGCGACAGTCGTGGCCTTTGCTA
ACCCACACAAGGACAAGGATGGCGATGGTCAGTGCCTCACCCCTTTTGCTCCCCTTCGATGCGCTCCTGG
GAACGCCGTTCGCGACCGTCGATACACCAGCGGCATTCGATGCCACCGTCGAGGCATGTAGAATCGAGCT
AAAGAGTTGGACAGGCCAAATCACTACAAAGGAGCTGGGCACCGTCATGCGCTCTCTCGGCCAGAACCCC
TCCGAGTCGGAGCTCCAAGACATGATCAACGAGGTCGACGCCGACAACAACGGCACCATCGACTTTCCCG
GTAGGTGGACATGCGGAATCCTGCGTCACACAATACAGGCCCGCTGACTGGTCTTCAGAGTTCCTGACTA
TGATGGCCCGCAAGATGAAGGATACCGACTCCGAAGAGGAGATTCGCGAGGCTTTCAAGGTTGGCTACGA
CGGTGCTTTTTCGCTGCGATATATGTTGACTCTGAATAGGTCTTTGACCGCGACAACAACGGCTTCATCT
CCGCCGCCGAGTTGCGTCACGTCATGACCTCCATTGGTGAGAAGCTTACCGACGACGAGGTTGACGAGAT
GATTCGCGAGGCCGATCAGGATGGCGATGGTCGCATTGACTGTGAGTGTCGATTGATTGGTATGCGTCAT
GGGCACTAACAGGCGGTGTAGACAACGAGTT

