>JX009837.1 Colletotrichum alatae strain C1275.5 chitin synthase (CHS) gene, partial cds
TGGGGCAAGGATGCTTGGAAGAAGATTGTCGTCTGTGTTGTCAGCGACGGTCGTGCCAAGATCAACCCGA
GAACAAGAGCACTGCTGGCCGGTATGGGTGTTTACCAGGAGGGTATTGCAAAGCAACAGGTCAATAACAG
GGATGTCACCGCCCACATTTACGAATACACGACACAGGTCGGCATGACGATCAAGAACGACGTTGTCTCC
TTGGTTCCCAAGCAGCAGCCCGTTCAGATGCTGTTCTGCTTGAAGGAGAAGAACCAGAAGAAGATCAACT
CTCACAGATGGTTCTTCCA

>JX009846.1 Colletotrichum alatae strain C1276.6 chitin synthase (CHS) gene, partial cds
TGGGGCAAGGATGCTTGGAAGAAGATTGTCGTCTGTGTTGTCAGCGACGGTCGTGCCAAGATCAACCCGA
GAACAAGAGCACTGCTGGCCGGTATGGGTGTTTACCAGGAGGGTATTGCAAAGCAACAGGTCAATAACAA
GGATGTCACCGCCCACATTTACGAATACACGACACAGGTCGGCATGACGATCAAGAACGACGTTGTCTCC
TTGGTTCCCAAGCAGCAGCCCGTTCAGATGCTGTTCTGCTTGAAGGAGAAGAACCAGAAGAAGATCAACT
CTCACAGATGGTTCTTCCA

>JX009844.1 Colletotrichum fructicola strain C1276.4 chitin synthase (CHS) gene, partial cds
TGGGGCAAGGATGCTTGGAAGAAGATTGTCGTCTGTGTTGTCAGCGACGGTCGTGCCAAGATCAACCCGC
GAACAAGAGCACTGCTGGCCGGTATGGGTGTGTACCAGGAGGGTATCGCGAAGCAACAGGTCAACAGCAA
GGATGTCACCGCCCACATTTACGAATACACGACCCAGGTCGGCATGACGATCAAGAACGACGTTGTCTCC
TTGGTTCCTAAGCAGCAGCCCGTTCAGATGCTGTTCTGCTTGAAGGAGAAGAACCAGAAGAAGATCAACT
CTCACAGATGGTTCTTCCA

>JX009847.1 Colletotrichum fructicola strain C1276.9 chitin synthase (CHS) gene, partial cds
TGGGGCAAGGATGCTTGGAAGAAGATTGTCGTCTGTGTTGTCAGCGACGGTCGTGCCAAGATCAACCCGC
GAACAAGAGCACTGCTGGCCGGTATGGGTGTGTACCAGGAGGGTATCGCGAAGCAACAGGTCAACAGCAA
GGATGTCACCGCCCACATTTACGAATACACGACCCAGGTCGGCATGACGATCAAGAACGACGTTGTCTCC
TTGGTTCCTAAGCAGCAGCCCGTTCAGATGCTGTTCTGCTTGAAGGAGAAGAACCAGAAGAAGATCAACT
CTCACAGATGGTTCTTCCA

>JX009845.1 Colletotrichum siamense strain C1276.5 chitin synthase (CHS) gene, partial cds
TGGGGCAAGGATGCTTGGAAGAAGATTGTCGTCTGTGTCGTCAGCGACGGTCGTGCCAAGATCAACCCGC
GAACAAGAGCACTGCTGGCCGGTATGGGTGTGTACCAGGAGGGTATCGCAAAGCAACAGGTCAACAGCAA
GGATGTCACCGCCCACATTTACGAATACACGACCCAGGTCGGCATGACGATCAAGAATGACGTTGTCTCC
TTAGTTCCTAAGCAGCAGCCCGTTCAGATGCTGTTCTGCTTGAAGGAGAAGAACCAGAAGAAGATCAACT
CTCACAGATGGTTCTTCCA

>JX009842.1 Colletotrichum siamense strain C1276.1 chitin synthase (CHS) gene, partial cds
TGGGGCAAGGATGCTTGGAAGAAGATTGTCGTCTGTGTCGTCAGCGACGGTCGTGCCAAGATCAACCCGC
GAACAAGAGCACTGCTGGCCGGTATGGGTGTGTACCAGGAGGGTATCGCAAAGCAACAGGTCAACAGCAA
GGATGTCACCGCCCACATTTACGAATACACGACCCAGGTCGGCATGACGATCAAGAACGACGTTGTCTCC
TTGGTTCCTAAGCAGCAGCCCGTTCAGATGCTGTTCTGCTTGAAGGAGAAGAACCAGAAGAAGATCAACT
CTCACAGATGGTTCTTCCA

