>JX010065.1 Colletotrichum alatae strain C1275.5 glutamine synthetase (GS) gene, intron 2 and partial cds
CGTCACACCCACCGGGTGTTGGCGCGGCTCGCCGCTCGCAAAAATCGCCGGCACTGCAGCCGGCGAATCC
TTTATACGGGCCAAATGATATACCTCTCCCAGCGTTAGCCCGCCACGCGTTGCAGCTGAGCCGGTTAATA
CCTCTCTCACGACCTGCGGTGGCGGGCGCAACAAAGCTGGGGAAGCGGCCCCGTGTCCTGAGGAGTCATC
CTCCCTCGGGGTCTCTCCGAATCTGCCCCGGAATGAGGTAGAGGCGGGTTGCTGCAGCAGGTTGCAGCGA
CGGCAAGCACTGGGGCTTGGCGGGGGTCAAATCACCGCCTGCCCCGCGGATACTGTATTGGGTGTTGGGT
TGGCAGTCGTTGTACGTACCTGCTCAGCTCTGCTCGGCTGGCTATTGCCAGTCTGCCGGGGCTGCTGGCT
GACAGGATTCGCACACGACTCGGTTCTGCAAGGAACCCCACCCCACCTGGCTGGTGCAGCGATTCCGAGG
CCTCGCCTTGCCTCCAGCTGCAGGGTTCAACGCGGCATCTCGGTTATTGCAGGTCTTGCAAACAAAAGTC
TGGAGGTGTCTTTGTCCGCTCGCCGCCGGGGCGCATTCTTTTTGCCGGTTGGCCAGCCGCCGGCGCGACG
TGATAGCGGTCACGACCCCACTGGCGATGGGCCCGAGACTCGAAAGCCCCGAATGAGCGACTGGAGCTCC
CCGCTTGATCGTCAGAGTTCGACGACAAGACGCATCGCATGATGTCAGCCTTGCAGGCCAAAGTTGGCCA
CGCCCCGAGCCTTCACCATGCCCCAGACTTGCATAATAGCACCACATTCGCCATATCGATACTGACAGTG
TGCGCCTACAGACACTCAA


>JX010136.1 Colletotrichum alatae strain C1276.6 glutamine synthetase (GS) gene, intron 2 and partial cds
CGTCACACCCACCGGGTGTTGGCGCGGCTCGCCGCTCGCAAAAATCGCCGGCACTGCAGCCGGCGAATCC
TTTATACGGGCCAAATGATATACCTCTCCCAGCGTTAGCCCGCCACGCGTTGCAGCTGAGCCGGTTAATA
CCTCTCTCACGACCTGCGGTGGCGGGCGCAACAAAGCTGGGGAAGCGGCCCCGTGTCCTGAGGAGTCATC
CTCCCTCGGGGTCTCTCCGAATCTGCCCCGGAATGAGGTAGAGGCGGGTTGCTGCAGCAGGTTGCAGCGA
CGGCAAGCACTGGGGCTTGGCGGGGGTCAAATCACCGCCTGCCCCGCGGATACTGTATTGGGTGTTGGGT
TGGCAGTCGTTGTACGTACCTGCTCAGCTCTGCTCGGCTGGCTATTGCCAGTCTGCCGGGGCTGCTGGCT
GACAGGATTCGCACACGACTCGGTTCTGCAAGGAACCCCACCCCACCTGGCTGGTGCAGCGATTCCGAGG
CCTCGCCTTGCCTCCAGCTGCAGGGTTCAACGCGGCATCTCGGTTATTGCAGGTCTTGCAAACAAAAGTC
TGGAGGTGTCTTTGTCCGCTCGCCGCCGGGGCGCATTCTTTTTGCCGGTTGGCCAGCCGCCGGCGTGACG
TGATAGCGGTCACGACCCCACTGGCGATGGGCCCGAGACTCGAAAGCCCCGAATGAGCGACTGGAGCTCC
CCGCTTGATCGTCAGAGTTCGACGACAAGACGCATCGCATGATGTCAGCCTTGCAGGCCAAAGTTGGCCA
CGCCCCGAGCCTTCACCATGCCCCAGACTTGCATAATAGCACCACATTCGCCATATCGATACTGACAGTG
TGCGCCTACAGACACTCAA

>JX010091.1 Colletotrichum fructicola strain C1276.4 glutamine synthetase (GS) gene, intron 2 and partial cds
TGTCACACCCGCCGGGCGCTGGCTCGGTTCGCCGCCCGCAAAATCGCCCGCACTGCTGCAGCCGGAGAAT
CCTTTACACGAGCAAAAGGATACGCCTCTTCCAGCGTTGGCCCGCCACGCGTTGCAGCTGAGCCGGTTAA
TGCCTCTCACGACCTGCGGCGGCGGGCGCAACAAAGCTGGGGAAGCGGCCCCGTGTTTTGAGGAATCATT
GCCTCGGGGTCTCTCCGAGTCTGCCCCGGACTGAGATTTAGGCGGGCTGCTGCAGCAGGTTGCGGCGACG
GCAAGCACTGGGGCTTGGCGGGGGTCAAACCACCGCCTGCCCCGCGGATGCTGTGTTGGGTGTTGGGTTG
GCGGTCGTTGTACGTACCTGCTCAGCTCTGCTCGGCTGGGCTTCTGGTTATTGCCAGTAGCCGGGGCTGC
TGGCTGACAGGATTCGCACACGACTCGGTTCTGCAAGGAACCCCACCCCACCTGGCTGGTGCAGCGACTC
CGAGGCCTCGCCTTGCCTCCAGCTGCAGGGTTCAACGCGGCATCTCGGGTATTGCAGGTCTTGCAAACAA
AAAGTCTAGAGGTGTCTTTGTCCGCTCGCCGCCGGGGCGCATCCTTTTTGCCGGTTGGCCAGCCGCCGGC
GCGACGTGATAGCGGTCACGACCCCACTGGCGATCGGCCCGAGACCCAAAAGCCCCGAATGAGCGACTGG
AGCTCCCCGCTTGAGCATCGTCAGTTCGACGACAAGGCGCATCGCATGATGTCAGCCTTGCCGGCCAAAG
TTGGCCACGCGCCGAGCATCTACCATGCCCAGACTTGCATCATAACGCCACATTCACGACATCGATACTG
ACAATGTGTGCCTACAGACACTCAA

>JX010092.1 Colletotrichum siamense strain C1276.5 glutamine synthetase (GS) gene, intron 2 and partial cds
TGTCACACCCGCCGGGCGATGGCTCGGTTCGCCGCCCGCAAAATCGCCCGCACTGCTGCAGCCGGAGAAT
CCTTTACACGAGCAAAAGGATACGCCTCTTCCAGCGTTGGCCCGCCACGCATTGCAGCTGAGCCGGTTAA
TGCCTCTCACGACCTGCGGCGGCGGGCGCAACAAAGCTGGGGAAGCGGCCCCGTGTTTTGAGGAATCATT
GCCTCGGGGTCTCTCCGAGTCTGCCCCGGACTGAAATTTAGGCGGGCTGCTGCAGCAGGTTGCGGCGACG
GCAAGCACTGGGGCTTGGCGGGGGTCAAACCACCGCCTGCCCCGCGGATGCTGTGTTGGATGTTGGGTTG
GCGGTCGTTGTACGTACCTGCTCAGCTCTGCTCGGCTGGGCTTCTGGTTATTGCCAGTAGCCGGGGCTGC
TGGCTGACAGGATTCGCACACGACTCGGTTCTGCAAGGAACCCCACCCCACCTGGCTGGTGCAGCGACTC
CGAGGCCTCGCCTTGCCTCCAGCTGCAGGGTTCAACGCGGCATCTCGGGTATTGCAGGTCTTGCAAACAA
AAAGTCTAGAGGCGTCTTTGTCCGCTCGCCGTCGGGGCGCATCCTTCTTGCCGGTTGGCCAGCCGCCGGC
GCGTCGTGATAGCGGTCACGACCCCACTGGCGATGGGCCTGAGACCCAAAAGCCCCGAATGGGCGACTGG
AGCTCCCCGCTTGAGCATCGTCAGTTCGACGACAAGGCGCATCGCATGATGTCAGCCTTGCCGGCCAAAG
TTGGCCACGCGCCGAGCATTCACCATGCCCAGATTTGCATCATAACGCCACATACACAACATCGATACTG
ACAATGTGCGCCTACAGACACTCAA

