>JX010305.1 Colletotrichum alatae strain C1275.5 manganese-superoxide dismutase (SOD2) gene, partial cds
ACCAAACCTACGTCACAAACCTGAACAAGGCTATCGAAACATACAACGCCAACCCTCTCCAAAGCCGCAT
CGCCGTTTTGGCAGCACTTAACTTCCACGGCGGCGGCCACATCAACCACTCCCTGTTCTGGGAGAACCTC
TCCCCGGCCTCCAGCCCGGATGCTTCTCCCAACTCCGCACCGAACCTGATTGCCGAGATCACCCGTGTCT
GGGGTGGTCTGGACAAGTTTAAGGAGGCTTTCAATACTGCGCTTTTGGGCATCACCGGCAGCGGCTGGGG
TTGGCTGGTCAAGGACGACACGACAGGTCTCAGCATCATCACGACCAAGGACCAGGACCCCGTCACCAAG
GGCGTGCCCATCTTCGGTGTCGAC

>JX010371.1 Colletotrichum alatae strain C1276.6 manganese-superoxide dismutase (SOD2) gene, partial cds
ACCAAACCTACGTCACAAACCTGAACAAGGCTATCGAAACATACAACGCCAACCCTCTCCAAAGCCGCAT
CGCCGTTTTGGCAGCACTTAACTTCCACGGCGGCGGCCACATCAACCACTCCCTGTTCTGGGAGAACCTC
TCCCCGGCCTCCAGCCCGGATGCTTCTCCCAACTCCGCACCGAACCTGATTGCCGAGATCACCCGTGTCT
GGGGTGGTCTGGACAAGTTTAAGGAGGCTTTCAATACTGCGCTTTTGGGCATCACCGGCAGCGGCTGGGG
TTGGCTGGTCAAGGACGACACGACAGGTCTCAGCATCATCACGACCAAGGACCAGGACCCCGTCACCAAG
GGCGTGCCCATCTTCGGTGTCGAC

>JX010323.1 Colletotrichum fructicola strain C1276.4 manganese-superoxide dismutase (SOD2) gene, partial cds
ACCAGACCTACGTCACAAACCTGAACAAAGCTATCGAAACATACAACGCCAACCCTCTCCAAAGCCGCAT
CGCCGTTTTGGCGGCACTCAACTTCCACGGCGGAGGCCACATCAACCACTCCCTCTTCTGGGAGAACCTC
TCCCCCGCCTCTAGCCCGGATGCTTCTCCCGACTCCGCACCCAGCCTGGTCGCCGAGATCGACCGCGTCT
GGGGCGGCCTCGACAAGTTCAAGCAATCATTCAACGCTGCGCTGTTGGGCATCACCGGCAGCGGCTGGGG
TTGGCTCGTCAAGGACGATACGACAGGTCTCAGCATCATCACGACCAAGGACCAGGACCCCGTCACCAAG
GGCGTGCCCATCTTCGGCATCGAC

>JX010324.1 Colletotrichum siamense strain C1276.5 manganese-superoxide dismutase (SOD2) gene, partial cds
ACCAGACCTACGTCACAAACCTAAACAAGGCCATCGAAACATACAACGCCAACCCTCTCCAAAGCCGCAT
CGCCGTTTTGGCGGCACTCAACTTTCACGGTGGAGGCCACATCAACCACTCCCTCTTCTGGGAGAACCTT
TCCCCCGCCTCTAGCCCAGATGCTTCTCCCGACTCCGCACCCAGCCTGATCGCCGAGATCACCCGCGTCT
GGGGCAGCCTGGATAAGTTCAAGCAAGCTTTCAACGCTGCGCTGTTGGGCATCACCGGCAGCGGCTGGGG
CTGGCTGGTCAAGGACGACACAACCGGCCTCAGCATCATCACGACCAAGGACCAGGACCCCGTCACCAAG
GGCGTGCCCATCTTCGGTGTCGAC

