>JX010383.1 Colletotrichum alatae strain C1275.5 beta-tubulin 2 (TUB2) gene, partial cds
CCATCACCACAATCACAACAACACCTGCGACGCGTTTATCCGCCTTGCCCCTGAGCGCAACCCCACCGAC
ATTTTTACCCGACTTCCATGCTCACCGAACTCGCGACGCCCGTCAACCATCGACTTCCTACTCTGGAATG
TTTTGCTGACTGCTACTTTTCTCTCTACAGGTTCACCTCCAGACCGGCCAGTGCGTAAGTCTCCCCAAGC
CAAATCCAACCGTCTGATTGCGGGGCTAACCTCCTTGTACAGGGTAACCAGATTGGTGCTGCCTTCTGGT
ACGTGGCGAGACTGCCGACGACCCGGCAATATCATACCTGCGAGAACGACAGATGTTGACGGTGGAGTAG
GCAAAACATTTCTGGCGAGCATGGCCTCGACAGCAATGGAGTGTATGTCATGTCCCTTATCTGGCCACAT
TGGTGGTTGACGGCTAAACTCGAATAGCTACAACGGCACCTCTGAGCTCCAGCTCGAGCGCATGAGCGTT
TACTTCAACGAAGTTTGTTACCTTTTAGCCCCCAGAGTGCAAGAAAAACATGTTGACGAGTACTGACCCT
CGCTCCCACCCAGGCGTCCGGCAACAAGTACGTGCCCCGTGCCGTCCTCGTCGATTTGGAGCCCGGTACC
ATGGACGCCGTCCGTGCCGGTCCTTTCGGCCAGCTCTTCCGCCCCGACAACTTCGTCTTCGGCCAGTCTG

>JX010449.1 Colletotrichum alatae strain C1276.6 beta-tubulin 2 (TUB2) gene, partial cds
CCATCACCACAATCACAACAACACCTGCGACGCGTTTATCCGCCTTGCCCCTGAGCGCAACCCCACCGAC
ATTTTTACCCGACTTCCATGCTCACCGAACTCGCGACGCCCGTCAACCATCGACTTCCTACTCTGGAATG
TTTTGCTGACTGCTACTTTTCTCTCTACAGGTTCACCTCCAGACCGGCCAGTGCGTAAGTCTCCCCAAGC
CAAATCCAACCGTCTGATTGCGGGGCTAACCTCCTTGTACAGGGTAACCAGATTGGTGCTGCCTTCTGGT
ACGTGGCGAGACTGCCGACGACCCGGCAATATCATACCTGCGAGAACGACAGATGTTGACGGTGGAGTAG
GCAAAACATTTCTGGCGAGCATGGCCTCGACAGCAATGGAGTGTATGTCATGTCCCTTATCTGGCCACAT
TGGTGGTTGACGGCTAAACTCGAATAGCTACAACGGCACCTCTGAGCTCCAGCTCGAGCGCATGAGCGTT
TACTTCAACGAAGTTTGTTACCTTTTAGCCCCCAGAGTGCAAGAAAAACATGTTGACGAGTACTGACCCT
CGCTCCCACCCAGGCGTCCGGCAACAAGTACGTGCCCCGTGCCGTCCTCGTCGATTTGGAGCCCGGTACC
ATGGACGCCGTCCGTGCCGGTCCTTTCGGCCAGCTCTTCCGCCCCGACAACTTCGTCTTCGGCCAGTCTG

>JX010401.1 Colletotrichum fructicola strain C1276.4 beta-tubulin 2 (TUB2) gene, partial cds
CCATCACCACAATCACAACAACGCTTGCGACGCGTTTATCCGCCTTGCCCTGAGCGTACCCCGCCGACAT
TTTTACCCGACTTCTATGCACAACAAACCCGCGACGCCTGTCAATCATCGACTCCCAACTCTGGATTGTT
TTGCTGACTGCTGCTTTTTTTCTCTACAGGTTCACCTCCAGACCGGCCAGTGCGTAAGTCTTCCCAAGCC
AAATCCAACCGCCTGATTGCGGGGCTAACCTCCTTGTACAGGGTAACCAGATTGGTGCTGCCTTCTGGTA
CGTGACGAGACCGCCGACGACCCGGCAATATATACTTGCGAGGACGGCAGATGTTGACGATAGAGTAGGC
AAAACATTTCTGGCGAGCACGGCCTCGACAGCAATGGAGTGTATGTCATGCCCCTTATCTGGCCACATTG
ATGGTTGACCGCTAAACTCGAACAGCTACAACGGCACCTCTGAGCTCCAGCTCGAGCGCATGAGCGTCTA
CTTCAACGAAGTTTGTTACCTTATAGCCCCCAGAGTGCAAGATAAACATATTGACGAGTACTGACCTTCG
CTCCTACCCAGGCTTCCGGCAACAAGTACGTGCCCCGTGCCGTCCTCGTCGATTTGGAGCCCGGTACCAT
GGACGCCGTCCGTGCCGGTCCTTTCGGCCAGCTCTTCCGCCCCGACAACTTCGTCTTCGGCCAGTCTG

>JX010402.1 Colletotrichum siamense strain C1276.5 beta-tubulin 2 (TUB2) gene, partial cds
CCATCACCACAATCACAAACAACGCTTGCGACGCGTTTATCCGCCTTGCCCTGAGCGTACCCCGCCGACA
TTTTTACCCGACTTCTATGCTCAACAAACCCGCGACGCCTGTCAATCATCGACGTCCAACTCTGGAATGT
TTTGCTGACTGCTGCTTTTTTTTGTCTACAGGTTCACCTCCAGACCGGCCAGTGCGTAAGTCTTCCCAAG
CCAAATCCAACCGCCTGATTGTGGGGCTAACCTCCTTGTACAGGGTAACCAGATTGGTGCTGCCTTCTGG
TACGTGACGAGACCGCCGACGATCCGGCAATATATACTTGCGAGGACGGCAGATGTTGACGATAGAGTAG
GCAAAACATTTCTGGCGAGCACGGCCTCGACAGCAATGGAGTGTATGTCATGCCCCTTATCTGGCCACAT
TGGTGGTTGACCGCTAAACTCGAACAGCTACAACGGCACCTCTGAGCTCCAGCTCGAGCGCATGAGCGTC
TACTTCAACGAAGTTTGTTACCTTATAGCCCCCAAAGATAAACATATTGACGAGTACTGACCTTCGCTCC
TACCCAGGCTTCCGGCAACAAGTACGTGCCCCGTGCCGTCCTCGTCGATTTGGAGCCCGGTACCATGGAC
GCCGTCCGTGCCGGTCCTTTCGGCCAGCTCTTCCGCCCCGACAACTTCGTCTTCGGCCAGTCTG


